GFGFTRGFGFGFGFGFGFGFGFGFGFGFTRGFGFGFGFGFGFGFGFGFGFGFGFGFGFGFGFGFGFGFGFGFGFGFGFGFGFFLGFGFTRGFGFGFGFGFGFGFGFFLGFGFGFGFGFGFGFGFGFGFFLGFGFGFTRGFGFFLGFGFGFGFGFGFTRGFGFGFGFGFGFTRGFFLGFGFGFGFGFGFTRFLGFGFGFGFGFGFGFGFGFGFTRTRGFGFGFFLGFFLTRTRGFGFGFGF
GFCWCWCWCWCWCWCWCWCWCWCWCWCWCWCWCWCWCWCWCWCWCWCWCWCWCWCWCWCWCWCWCWCWCWCWCWCWCWCWCWCWCWCWCWCWCWCWCWCWCWCWCWCWCWCWCWCWCWCWCWCWCWCWCWCWCWCWCWCWCWCWCWCWCWCWCWCWCWCWCWCWCWCWCWCWCWCWCWCWCWCWCWCWCWCWCWCWCWCWCWCWCWCWCWCWCWCWCWCWCWCWCWCWCWCWCWCWCWTR
GFCWCWCWCWCWCWCWCWCWCWCWCWCWCWCWCWCWCWCWCWCWCWCWCWCWCWCWCWCWCWCWCWCWCWCWCWCWCWCWCWCWCWCWCWCWCWCWCWCWCWCWCWCWCWCWCWCWCWCWCWCWCWCWCWCWCWCWCWCWCWCWCWCWCWCWCWCWCWCWCWCWCWCWCWCWCWCWCWCWCWCWCWCWCWCWCWCWCWCWCWCWCWCWCWCWCWCWCWCWCWCWCWCWCWCWCWCWCWGF
FLCWCWCWGFTRGFGFTRGFGFTRGFGFGFTRGFTRGFTRGFGFTRGFGFTRGFTRGFTRGFTRGFGFGFTRGFGFGFTRGFTRGFGFGFCPCPCPCPCPCPCPCPCPCPCPCPCPCPCPCPCPCPCPCPCPCPCPCPCPCPCPCPCPCPCPGFTRGFTRGFTRGFGFTRGFGFTRGFTRGFGFTRGFGFGFTRGFFLGFTRGFTRGFTRGFGFTRGFTRGFTRGFGFTRGFCWCWCWGF
GFCWCWGFGFGFGFGFGFGFGFGFGFGFTRGFGFGFGFGFGFGFGFGFGFGFGFGFTRGFTRGFGFGFGFGFGFFLGFGFGFGFGFGFGFCPLTCPCPCPCPCPCPCPCPCPCPCPCPCPCPCPCPCPCPCPCPCPCPCPCPCPCPCPLTCPGFGFGFGFGFGFGFGFGFGFGFGFGFGFGFGFGFGFGFGFGFGFGFGFGFGFGFGFGFTRGFFLGFGFGFFLGFGFGFGFGFCWCWGF
GFCWCWGFGFGFGFGFGFGFGFGFGFGFFLGFGFGFGFGFGFGFGFGFGFGFGFGFGFGFGFGFGFGFGFGFFLGFGFGFGFGFGFGFGFCPCPSWSWSWSWSWSWSWSWSWSWSWSWWNWNWNSWSWSWSWSWSWSWSWSWSWSWSWCPCPGFGFGFGFGFGFGFGFGFGFGFGFGFTRGFGFGFGFFLGFGFGFCPGFGFGFGFGFGFGFGFGFGFGFGFGFGFTRGFGFGFCWCWGF
TRCWCWTRGFGFGFGFGFGFGFGFGFGFFLGFGFGFGFGFGFGFGFGFGFGFGFGFGFGFGFGFGFFLGFGFGFGFGFGFGFGFGFGFGFCPCPSWSFSFSFSFSFSFSFSFSFSFSFSFSFSFSFSFSFSFSFSFSFSFSFSFSFSWCPCPGFGFGFGFBLGFGFGFGFGFGFGFGFGFGFGFGFGFGFGFGFGFCPGFGFGFGFGFGFGFGFGFTRGFGFGFGFGFGFGFTRCWCWGF
TRCWCWGFGFGFGFGFGFGFGFGFGFGFGFGFGFGFGFGFGFGFGFGFGFGFGFGFGFGFGFGFGFGFGFGFGFGFGFGFFLGFGFGFGFCPCPWNSFSFSFSFSFSFSFSFSFSFGAFTALFTGASFSFSFSFSFSFSFSFSFSFWNCPCPSWSWWNSWSWSWGFTRGFGFGFGFGFGFGFSWSWSWWNSWSWSWCPSWSWWNSWSWSWGFFLGFTRGFGFGFGFGFGFGFGFCWCWGF
GFCWCWGFGFGFGFGFGFGFGFGFGFGFGFGFGFGFGFTRGFGFGFGFGFGFGFGFTRGFGFGFGFGFGFGFGFGFGFGFGFGFCRGFGFCPCPSWFTSFSFSFSFSFSFSFSFSFSFSFCHSFSFSFSFSFSFSFSFSFSFSFFTSWCPCPWDFTWFWFTBSWGFGFGFGFGFGFGFGFGFSWFTWFWFWFTBWDCPWDFTWFWFTBSWGFGFGFGFGFGFFLGFGFGFGFGFCWCWGF
GFCWCWGFGFGFGFGFGFTRGFGFGFGFGFGFGFGFGFTRGFGFGFGFGFBLGFGFGFGFGFGFGFGFFLGFGFGFGFGFSWSWSWSWSWCPCPWNSFPWPWPWPWPWPWPWPWPWPWSFSFSFPWPWPWPWPWPWPWPWPWPWSFWNCPCPSWWFCHWTBBSWGFGFGFGFGFBLGFGFGFSWCHWTWFWFBBSWCPSWWFCHWTBBSWGFGFFLGFGFGFGFGFGFFLGFGFCWCWGF
GFCWCWTRGFGFGFGFGFGFGFGFGFGFGFGFGFGFGFGFGFGFGFFLGFSWSWWNSWSWSWGFFLGFGFGFGFGFGFCRSWFTWFTBWDCPCPSWSFPWPWPWPWPWPWPWPWPWPWSFSFSFPWPWPWPWPWPWPWPWPWPWSFSWCPCPSWWFWFWFFTSWGFGFSWSWWNSWSWSWGFSWSWSWWNSWSWSWCPSWWFWFWFFTSWGFGFGFGFFLGFGFGFGFGFGFTRCWCWGF
GFCWCWGFGFGFGFGFFLGFGFBLCRGFGFGFGFGFGFGFGFGFGFGFGFSWFTCRWFTBSWGFFLGFGFGFGFBLGFGFSWWFWFBBSWCPCPWNFTSFSFSFSFSFSFSFSFSFSFSFSFSFSFSFSFSFSFSFSFSFSFSFFTWNCPCPSWSWWNSWSWSWGFGFSWFTWFWFTBSWGFSWSWWNSWSWSWGFCPSWSWWNSWSWSWGFGFCRGFGFGFGFTRGFGFGFGFCWCWTR
GFCWCWGFGFTRGFGFGFGFGFSWSWSWWNSWSWSWSWSWWNSWSWSWGFSWWFWFWFBBSWBLGFGFSWSWWNSWSWSWWNCHWTCHWNCPCPSWSFPWPWPWPWPWPWPWPWPWPWSFSFSFPWPWPWPWPWPWPWPWPWPWSFSWCPCPSWSWSWWNSWSWSWGFSWWFCHWTBBSWGFSWFTCRWFTBSWGFCPGFBLGFSWSWSWWNSWSWSWGFGFGFGFGFGFGFGFCWCWGF
GFCWCWTRGFGFGFGFGFGFGFSWFTWFWFWFTBSWSWFTWFWFTBSWGFWNWFCHWTCHWNGFGFGFSWFTWFWFTBSWSWWFWFWFSWCPCPWNSFPWPWPWPWPWPWPWPWPWPWSFSFSFPWPWPWPWPWPWPWPWPWPWSFWNCPCPWDFTWFWFWFTBSWGFSWWFWFWFFTSWGFWNWFWFWFBBWNGFCPGFGFCRSWFTWFWFWFTBSWGFGFGFGFGFGFGFTRCWCWGF
GFCWCWGFGFGFTRGFGFGFGFSWWFCHWTCHBBSWSWWFCHWTBBSWGFSWWFWFWFWFSWCRGFGFSWWFCHWTBBSWSWWFWFFTSWCPCPSWFTSFSFSFSFSFSFSFSFSFSFSFSFSFSFSFSFSFSFSFSFSFSFSFFTSWCPCPSWCHWTWFWFBBSWGFSWSWWNSWSWWDGFSWWFCHWTCHSWGFCPGFGFGFSWWFCHWTCHBBSWGFGFGFGFFLGFGFGFCWCWGF
TRCWCWGFGFGFGFGFGFGFGFSWWFWFWFWFFTSWSWWFWFWFFTSWGFSWBKWFWFFTSWGFGFGFSWWFWFWFFTSWSWSWSWSWSWCPCPWNSFPWPWPWPWPWPWPWPWPWPWSFSFSFPWPWPWPWPWPWPWPWPWPWSFWNCPCPSWSWSWWNSWSWSWGFGFGFGFGFGFCPGFSWBKWFWFFTSWGFCPGFGFGFSWWFWFWFWFFTSWGFGFGFGFGFGFGFGFCWCWGF
GFCWCWGFGFGFGFGFGFGFGFSWSWWDWNSWSWSWSWWDWNSWSWSWBLSWWDWNSWSWSWGFGFGFSWWDWNSWSWSWGFGFGFGFGFCPCPSWSFPWPWPWPWPWPWPWPWPWPWSFSFSFPWPWPWPWPWPWPWPWPWPWSFSWCPCPGFGFGFGFGFGFGFGFGFGFGFGFTRCPGFSWWDWNSWSWSWGFCPGFGFGFSWWDSWWNSWSWSWGFGFGFFLGFGFGFGFCWCWGF
GFCWCWTRGFGFGFGFGFGFGFGFGFCPCPCPCPCPCPCPCPCPCPCPCPCPCPCPCPCPCPCPCPCPCPCPCPCPCPCPCPCPCPCPCPCPCPWNFTSFSFSFSFSFSFSFSFSFSFSFSFSFSFSFSFSFSFSFSFSFSFSFFTWNCPCPCPCPCPCPCPCPCPCPCPCPCPCPCPCPCPCPCPCPCPCPCPCPCPCPCPCPCPCPGFGFGFGFGFGFGFGFGFGFGFGFTRCWCWFL
GFCWCWGFGFGFGFGFGFSWSWSWWNWDSWSWCPGFSWWDSWSWSWSWWDSWSWSWGFGFGFGFGFGFGFGFGFGFGFFLGFCPGFGFGFCPCPSWSFPWPWPWPWPWPWPWPWPWPWSFSFSFPWPWPWPWPWPWPWPWPWPWSFSWCPCPGFBLSWWDWNSWSWSWGFGFGFCPGFCPGFGFGFGFFLGFGFGFCPGFSWWDSWWNSWSWSWGFGFGFFLGFGFGFGFGFGFCWCWGF
GFCWCWGFGFGFFLGFCPSWFTWFWFWFTBSWCPGFSWFTWFTBSWSWFTCRTBSWGFGFGFGFGFGFGFGFGFGFGFGFGFCPGFGFGFCPCPWNSFPWPWPWPWPWPWPWPWPWPWSFSFSFPWPWPWPWPWPWPWPWPWPWSFWNCPCPGFCRSWFTWFWFTBSWGFGFGFCPGFCPGFGFGFGFGFGFGFGFCPGFSWFTWFWFWFTBSWGFGFGFGFGFGFGFGFGFGFCWCWGF
GFCWCWTRGFGFGFGFCPSWCHWTWFWFBBSWCPGFSWWFWFBBSWSWWFWFBBSWGFGFGFGFGFGFGFGFGFGFGFGFGFCPGFGFGFCPCPSWFTSFSFSFSFSFSFSFSFSFSFSFSFSFSFSFSFSFSFSFSFSFSFSFFTSWCPCPGFGFSWWFCHWTBBSWGFGFGFCPGFGFGFGFCRBLGFGFGFGFCPGFSWCHWTWFWFBBSWGFGFGFGFGFGFGFGFGFTRCWCWGF
GFCWCWGFFLGFGFGFCPSWSWSWWNSWSWSWCPGFWNCHWTCHWNWNWFWFWFWNGFGFGFGFGFGFGFGFGFBLGFGFGFCPGFGFGFCPCPWNSFPWPWPWPWPWPWPWPWPWPWSFSFSFPWPWPWPWPWPWPWPWPWPWSFWNCPCPGFGFSWWFWFWFFTSWGFGFGFCPGFSWSWWNSWSWSWGFGFGFCPGFSWSWSWWNSWSWSWGFGFGFGFGFGFGFGFTRFLCWCWGF
TRCWCWGFGFGFGFGFCPGFGFGFGFGFBLLTCPGFSWWFWFWFSWSWCHWTCHSWGFGFGFGFSWSWWNSWSWSWCRGFGFCPGFGFLTCPCPSWSFPWPWPWPWPWPWPWPWPWPWSFSFSFPWPWPWPWPWPWPWPWPWPWSFSWCPCPGFGFSWSWWNSWSWSWGFGFGFCPGFSWFTCRWFTBSWGFGFLTCPGFSWSWWNSWSWSWGFGFGFGFGFGFGFFLGFGFGFCWCWGF
GFCWCWTRFLGFFLGFCPGFGFGFGFGFGFGFCPGFSWWFWFFTSWSWWFWFWFSWGFGFGFGFSWFTWFWFTBSWGFGFFLCPGFGFGFCPCPWNFTSFSFSFSFSFSFSFSFSFSFSFSFSFSFSFSFSFSFSFSFSFSFSFFTWNCPCPGFGFGFGFGFGFGFBLGFFLGFCPGFWNWFWFWFBBWNGFGFGFCPGFSWFTWFWFTBSWGFGFGFFLGFGFGFGFGFGFTRCWCWGF
FLCWCWGFGFGFGFGFCPGFGFGFGFTRGFGFCPGFSWSWSWSWSWSWBKWFFTSWGFGFGFGFSWWFCHWTBBSWGFGFTRCPGFGFGFCPCPSWSFPWPWPWPWPWPWPWPWPWPWSFSFSFPWPWPWPWPWPWPWPWPWPWSFSWCPCPGFGFGFGFGFGFGFGFGFGFGFCPGFSWWFCHWTCHSWGFGFGFCPGFSWWFCHWTBBSWGFGFGFGFGFGFGFGFGFGFGFCWCWGF
GFCWCWTRGFGFFLGFCPGFGFGFGFGFGFGFCPGFGFGFGFGFGFSWSWSWSWSWGFGFGFGFSWWFWFWFFTSWGFFLGFCPFLFLGFCPCPWNSFPWPWPWPWPWPWPWPWPWPWSFSFSFPWPWPWPWPWPWPWPWPWPWSFWNCPCPGFGFGFGFGFGFGFGFGFGFGFGFGFSWBKWFWFFTSWCRGFGFCPCPSWWFWFWFFTSWGFGFGFGFGFGFGFGFGFGFTRCWCWGF
GFCWCWGFGFGFGFGFCPGFGFGFFLGFGFGFCPGFGFGFGFGFGFGFGFGFGFGFGFGFGFGFSWWDWNSWSWSWGFGFGFCPGFGFGFCPCPSWFTSFSFSFSFSFSFSFSFSFSFSFSFSFSFSFSFSFSFSFSFSFSFSFFTSWCPCPGFGFGFGFGFGFTRGFGFGFGFGFGFSWWDWNSWSWSWGFGFGFCPCPSWWDWNSWSWSWGFGFGFGFGFTRGFGFGFGFGFCWCWGF
GFCWCWGFGFGFGFGFCPCPCPCPCPCPCPCPCPCPCPCPCPCPCPCPCPCPCPCPCPCPCPCPCPCPCPCPCPCPCPCPCPCPCPCPCPCPCPWNSFSFSFSFSFSFSFSFSFSFSFSFSFSFSFSFSFSFSFSFSFSFSFSFSFWNCPCPCPCPCPCPCPCPCPCPCPCPCPCPCPCPCPCPCPCPCPCPCPCPCPCPCPCPCPCPCPGFGFGFGFGFGFGFGFGFGFGFGFCWCWGF
GFCWCWGFGFGFGFGFCPGFSWWDSWSWSWGFCPGFGFGFGFGFGFGFGFGFGFGFGFGFGFGFGFGFGFGFGFGFGFFLGFCPGFGFGFCPCPSWSFSFSFSFSFSFSFSFSFSFSFSFSFSFSFSFSFSFSFSFSFSFSFSFSFSWCPCPGFGFGFGFGFGFGFGFGFGFGFGFGFSWWDSWWNSWSWSWGFGFCPCPGFGFGFGFGFGFGFGFGFGFGFGFGFGFTRGFGFCWCWGF
GFCWCWTRGFGFGFGFCPGFSWFTCRTBSWCRCPSWSWWNSWSWSWGFGFFLGFGFGFGFGFGFGFSWSWSWSWSWCRGFGFLTTRTRGFCPCPWNSFSFSFSFSFSFSFSFSFSFSFSFSFSFSFSFSFSFSFSFSFSFSFSFSFWNCPCPSWSWSWSWSWGFGFGFGFGFFLGFGFSWFTWFWFWFTBSWGFGFCPCPGFGFGFGFGFGFGFGFGFGFGFGFGFGFGFGFTRCWCWGF
GFCWCWGFGFGFFLTRCPGFSWWFWFBBSWGFCPWDFTWFWFTBSWGFGFGFGFGFGFGFGFGFGFSWFTCRTBSWGFGFGFGFGFGFGFCPCPSWSFSFSFSFSFSFSFSFSFSFSFSFSFSFSFSFSFSFSFSFSFSFSFSFSFSWCPCPWDFTWFTBSWGFGFCRGFGFGFGFCRSWWFCHWTCHBBSWGFGFCPCPGFGFGFGFGFGFGFGFGFFLGFGFGFGFGFGFGFCWCWGF
GFCWCWTRGFGFTRGFCPGFWNWFWFWFWNGFCPSWWFCHWTBBSWSWSWWNSWSWSWGFGFGFGFSWWFWFBBSWGFGFSWSWSWSWSWCPCPSWSWSWSWSWSWSWSWSWSWSWSWSWWDSWSWSWSWSWSWSWSWSWSWSWSWSWCPCPWNWFWFBBWNGFSWSWSWSWSWGFGFSWWFWFWFWFFTSWGFGFCPSWSWSWWNSWSWSWGFGFGFGFGFGFGFGFGFGFTRCWCWGF
GFCWCWGFGFGFGFGFCPGFSWCHWTCHSWGFCPSWWFWFWFFTSWSWFTCRWFTBSWGFGFTRGFWNWFWFWFWNGFGFSWFTWFTBSWCPLTCPCPCPCPCPCPCPCPCPCPFOCPCPCPCPCPFOCPCPCPCPCPCPCPCPCPCPLTCPSWCHWTCHSWGFSWFTWFTBSWGFGFSWSWSWWNSWSWSWGFGFCPWDFTWFWFWFTBSWGFGFGFGFGFGFGFGFGFGFGFCWCWGF
GFCWCWFLGFGFGFGFCPGFSWWFWFWFSWGFCPSWSWWNSWSWSWWNWFWFWFBBWNGFGFGFGFSWCHWTCHSWGFGFWNWFWFBBWNCPCPCPCPCPCPCPCPCPCPCPCPCPCPCPCPCPCPCPCPCPCPCPCPCPCPCPCPCPCPCPSWWFWFFTSWGFWNWFWFBBWNGFGFSWSWSWWNSWSWSWGFGFCPSWWFCHWTCHBBSWGFGFGFGFGFGFGFGFGFGFGFCWCWGF
GFCWCWGFGFGFGFGFCPGFSWBKWFFTSWGFCPGFGFGFGFGFGFSWWFCHWTCHSWGFGFGFGFSWWFWFWFSWGFGFSWCHWTCHSWGFGFGFFLGFGFGFFLGFGFGFGFGFGFGFCPCPGFGFGFGFFLGFGFGFTRGFTRGFGFCRSWSWSWSWSWGFSWCHWTCHSWGFCRSWFTWFWFWFTBSWGFFLCPSWWFWFWFWFFTSWGFGFGFGFGFGFGFGFGFGFGFCWCWGF
FLCWCWTRGFGFTRGFCPGFSWSWSWSWSWGFCPGFFLGFGFGFGFSWBKWFWFFTSWGFGFGFGFSWBKWFFTSWGFGFSWWFWFFTSWGFGFGFGFGFGFGFGFGFGFGFGFGFGFGFCPCPGFTRGFGFGFGFGFGFGFGFGFGFGFGFGFGFGFGFGFGFSWWFWFFTSWGFGFSWCHWTWFWFBBSWGFGFCPSWSWSWWNSWSWSWGFGFGFGFGFGFGFGFGFGFTRCWCWGF
GFCWCWGFGFGFGFGFCPGFGFGFGFGFGFGFCPGFGFGFGFGFGFSWWDWNSWSWSWGFGFGFGFSWWDSWSWSWBLGFSWWDSWSWSWGFGFGFGFGFGFGFGFGFTRGFGFGFGFGFCPCPGFTRGFGFGFGFGFGFGFGFGFGFGFGFGFGFGFGFGFBLSWWDSWSWSWGFGFSWWDSWWNSWSWSWGFGFCPGFGFGFGFGFGFGFGFGFFLGFGFGFGFGFGFGFGFCWCWGF
GFCWCWGFGFCPCPCPCPCPCPCPCPCPCPCPCPCPCPCPCPCPCPCPCPCPCPCPCPCPCPCPCPCPCPCPCPCPCPCPCPCPCPCPCPCPCPCPCPCPCPCPCPCPCPCPCPCPCPCPCPCPCPCPCPCPCPCPCPCPCPCPCPCPCPCPCPCPCPCPCPCPCPCPCPCPCPCPCPCPCPCPCPGFGFGFGFGFCPGFGFGFGFGFGFGFGFGFGFGFGFGFGFGFGFGFGFCWCWGF
GFCWCWGFGFGFGFGFCPGFGFGFGFGFGFGFCPGFGFGFTRGFGFSWWDSWWNSWSWSWGFGFGFGFSWWDSWWNSWSWSWGFGFGFSWWDSWSWSWGFSWWDSWSWSWGFGFGFGFGFCPCPGFGFGFGFGFGFGFGFGFGFGFGFSWWDSWSWSWGFGFGFFLGFGFSWWDWNSWSWSWGFSWSWWNSWSWSWCPGFGFGFGFGFGFGFGFGFGFGFGFGFGFGFGFGFGFCWCWTR
TRCWCWTRGFGFGFGFCPLTGFGFGFGFGFLTCPGFGFGFGFTRGFSWFTCRWFWFTBSWGFGFGFGFSWFTWFWFWFTBSWGFGFGFSWFTWFTBSWGFSWFTWFTBSWGFGFGFGFGFCPCPGFGFGFBLGFGFGFGFBLGFGFGFSWFTWFTBSWGFCPCPFLTRGFSWFTWFWFTBSWGFSWFTCRWFTBWDCPGFGFGFGFGFGFGFGFGFGFGFGFGFGFGFGFGFTRCWCWGF
GFCWCWGFGFGFTRGFCPGFGFGFGFGFGFGFCPGFGFGFGFGFGFWNWFWFWFWFBBWNGFGFGFCRSWCHWTWFWFBBSWGFGFGFWNWFWFBBWNGFSWCHWTBBSWCRGFGFGFGFCPCPGFGFSWSWSWWNSWSWSWGFGFGFWNWFWFBBWNGFCPCPGFGFGFSWWFCHWTBBSWGFWNWFWFWFBBWNCPGFGFGFGFGFGFGFGFGFGFGFGFGFGFGFGFGFGFCWCWGF
GFCWCWGFGFGFGFGFCPGFFLGFGFGFGFGFCPGFGFGFGFCPGFSWWFCHWTCHWFSWGFGFGFGFSWSWSWWNSWSWSWGFGFGFSWCHWTCHSWGFSWWFWFFTSWGFGFGFGFGFCPCPGFGFSWFTWFWFWFTBSWGFGFGFSWCHWTCHSWGFCPCPGFGFGFSWWFWFWFFTSWGFSWWFCHWTCHSWCPSWSWSWWNSWSWSWGFGFGFGFGFTRGFGFGFGFGFCWCWGF
GFCWCWTRGFGFGFGFCPTRGFGFGFGFGFGFCPGFGFGFGFCPGFSWBKWFWFWFFTSWGFSWSWWNSWSWSWBLGFGFGFGFGFGFSWWFWFFTSWGFSWSWSWSWSWGFGFGFCPCPCPCPCPGFSWCHWTWFWFBBSWGFGFGFSWWFWFFTSWGFCPCPGFGFGFSWSWWNSWSWSWGFSWBKWFWFFTSWCPWDFTWFWFWFTBSWGFGFGFGFGFGFGFGFGFGFTRCWCWGF
GFCWCWGFGFGFGFFLCPLTBLCRGFGFGFGFCPGFGFGFLTCPGFSWSWSWWNSWSWSWGFSWFTWFWFTBSWGFGFGFGFGFGFGFSWSWSWSWSWGFBLGFGFGFGFGFGFLTCPCPCPCPCPLTWDSWSWWNSWSWSWGFGFGFSWSWSWSWSWGFCPCPGFGFGFGFGFGFGFCRGFGFSWSWWNSWSWSWCPSWCHWTWFWFBBSWGFGFGFGFGFTRGFGFGFGFGFCWCWGF
GFCWCWFLGFGFGFGFCPGFSWSWWNSWSWSWCPGFGFGFGFCPGFGFGFCRGFBLGFGFGFSWWFCHWTBBSWGFGFGFGFGFGFGFGFGFGFGFCRGFGFGFGFGFGFGFCPCPCPCPCPCPCPCPCPGFGFGFGFGFGFGFGFGFGFGFGFGFGFGFCPCPGFGFGFGFGFGFGFGFGFGFGFGFGFGFGFGFCPSWSWSWWNSWSWSWGFGFGFGFGFGFGFGFGFGFGFCWCWGF
GFCWCWTRGFGFGFGFCPGFSWFTCRWFTBWDCPGFGFGFGFCPSWSWWNSWSWSWGFGFCPWDWFWFWFFTSWGFGFGFGFGFGFGFFLGFGFGFGFGFGFGFGFGFGFGFCPCPCPCPCPCPCPCPCPGFGFGFGFFLGFGFGFGFGFGFGFGFGFGFCPCPGFGFGFGFGFBLGFGFGFGFGFGFSWSWSWWNWDSWSWGFGFGFGFGFGFGFGFGFGFFLGFGFGFGFTRCWCWGF
GFCWCWGFGFGFGFGFGFGFWNWFWFWFBBWNCPGFGFGFGFCPWDFTWFWFTBSWGFGFCPSWSWWNSWSWSWGFGFGFGFGFGFFLGFGFGFGFGFGFGFGFGFCRMKGFCPCPCPCPWLCPCPCPCPGFMKGFGFGFGFGFGFSWSWSWWNSWSWSWCPCPSWSWSWWNSWSWSWGFGFGFGFGFSWFTWFWFWFTBSWGFFLGFGFGFGFGFGFFLGFGFGFGFGFGFGFCWCWGF
GFCWCWTRGFGFGFGFGFGFSWWFCHWTCHSWCPGFGFGFGFCPSWWFCHWTBBSWGFGFCPBLSWSWSWSWSWGFGFGFGFGFGFGFGFFLGFGFGFGFGFSWSWSWSWSWCPCPCPCPCPCPCPCPCPSWSWSWSWSWGFGFGFSWFTCRWFWFTBWDCPCPWDFTWFWFWFTBSWGFTRGFGFGFSWCHWTWFWFBBSWGFGFGFGFGFGFGFGFGFGFGFGFGFGFGFTRCWCWGF
GFCWCWGFGFGFFLGFGFGFSWBKWFWFFTSWCPGFGFGFGFCPSWWFWFWFFTSWGFGFCPGFSWFTCRTBSWGFGFGFGFGFGFGFGFFLGFGFGFGFGFSWFTWFTBWDCPCPCPCPCPCPCPCPCPWDFTWFTBSWGFGFGFWNWFWFWFWFBBWNCPCPSWCHWTWFWFBBSWGFGFGFGFGFSWSWSWWNSWSWSWGFGFGFGFTRGFGFGFGFGFGFGFGFGFGFGFCWCWGF
GFCWCWTRGFGFGFGFGFGFSWSWWNSWSWSWCPGFGFFLGFCPSWSWWNSWSWSWGFGFCPGFSWWFWFBBSWGFGFGFBLGFGFGFGFGFGFTRGFGFBLSWCHWTBBSWGFLTCPCPCPCPCPLTGFWNWFWFBBWNGFGFGFSWWFCHWTCHWFSWCPCPSWSWSWWNSWSWSWGFGFGFGFGFGFGFGFGFGFGFGFGFGFGFGFGFGFGFGFGFGFGFGFGFFLGFTRCWCWGF
GFCWCWGFTRGFGFFLGFGFGFGFGFGFGFGFCPGFGFGFGFCPSWSWSWWNSWSWSWGFCPGFWNWFWFWFWNGFGFSWSWSWSWSWBLGFGFGFGFGFGFSWWFWFFTSWGFGFCPCPCPCPCPGFGFSWCHWTCHSWGFGFGFSWBKWFWFWFFTSWCPCPGFGFGFGFSWSWSWWNSWSWSWGFGFGFFLGFGFGFGFGFGFGFGFGFGFFLGFGFGFGFGFGFTRGFGFCWCWGF
GFCWCWTRGFGFTRGFGFGFGFGFFLGFGFGFCPGFFLGFGFCPWDFTWFWFWFTBSWGFCPGFSWCHWTCHSWGFGFSWFTWFTBSWGFGFGFGFGFGFGFSWSWSWSWSWGFGFLTGFCPCPGFGFGFSWWFWFFTSWGFGFGFSWSWSWWNSWSWSWCPCPLTGFTRGFSWFTWFWFWFTBSWGFGFGFGFGFGFGFGFGFGFGFGFGFGFGFGFGFGFGFGFGFGFGFTRCWCWGF
GFCWCWGFTRGFGFGFGFGFGFGFGFGFGFGFCPGFGFGFTRCPSWCHWTWFWFBBSWGFCPGFSWWFWFWFSWGFGFSWCHWTBBSWGFGFGFTRGFGFGFGFCRGFGFGFGFGFGFGFCPCPFLGFCRSWSWSWSWSWGFGFGFGFGFGFGFGFGFGFCPCPGFGFGFGFSWWFCHWTCHBBSWGFGFGFGFGFGFGFGFGFGFFLGFGFGFGFGFGFTRGFGFGFFLGFGFCWCWGF
GFCWCWTRGFGFGFGFGFGFGFGFGFGFGFGFCPGFGFGFGFCPSWSWSWWNSWSWSWGFCPGFSWBKWFFTSWGFGFSWWFWFFTSWGFGFGFGFGFGFGFGFGFGFGFGFGFTRGFGFCPCPTRGFGFGFGFGFGFGFGFGFGFGFGFGFGFGFGFGFCPCPGFGFGFGFSWWFWFWFWFFTSWGFGFGFGFGFGFTRGFGFFLGFGFGFGFFLGFGFGFGFGFTRGFGFTRCWCWGF
GFCWCWGFGFGFTRGFGFGFGFTRGFGFGFGFCPGFGFGFTRCPGFGFGFGFGFCRGFGFCPGFSWWDSWSWSWGFGFSWWDSWSWSWGFFLTRGFGFGFGFGFGFGFGFFLGFTRGFGFCPCPGFGFGFGFGFGFGFGFGFGFGFFLFLGFGFGFGFGFCPCPGFGFTRGFSWWDSWWNSWSWSWGFGFGFGFGFGFGFTRFLTRGFGFGFGFTRGFGFFLGFGFGFGFGFFLCWCWGF
GFCWCWGFGFCPCPCPCPCPCPCPCPCPCPCPCPCPCPCPCPCPCPCPCPCPCPCPCPCPCPCPCPCPCPCPCPCPCPCPCPCPCPCPCPCPCPCPCPCPCPCPCPCPCPCPCPCPCPCPCPCPCPCPCPCPCPCPCPCPCPCPCPCPCPCPCPCPCPCPCPCPCPCPCPCPCPCPCPGFGFGFGFGFGFFLGFGFGFGFGFGFGFGFGFTRGFGFGFFLGFFLGFGFGFGFGFCWCWGF
FLCWCWTRGFGFGFGFGFTRGFGFGFGFGFGFCPGFGFGFGFCPGFGFGFGFGFGFGFFLCPGFGFSWWDSWWNSWSWSWGFGFGFGFGFGFGFTRGFGFGFGFGFGFFLGFGFGFGFGFCPCPSWWDWNSWSWSWGFFLGFGFFLGFGFGFFLGFFLGFGFCPGFSWWDSWWNSWSWSWGFGFGFGFFLGFGFGFGFGFGFGFGFGFGFGFGFGFGFGFGFGFGFGFTRGFTRCWCWGF
GFCWCWGFGFGFGFGFGFGFFLGFGFGFGFGFCPGFGFGFGFCPGFGFGFGFGFGFGFGFCPGFGFSWFTWFWFWFTBSWGFGFGFGFGFGFGFGFGFGFGFGFGFGFGFGFGFGFGFGFCPCPSWFTWFWFTBSWGFGFGFGFGFGFGFGFBLCRGFGFGFCPGFSWFTWFWFWFTBSWGFGFGFGFGFGFGFGFGFGFFLGFGFTRGFGFTRGFGFGFGFGFGFGFGFGFGFCWCWGF
GFCWCWGFGFGFGFGFGFGFGFGFGFGFGFGFCPGFGFGFFLCPGFGFGFGFCRGFGFGFCPGFGFSWCHWTWFWFBBSWGFGFGFGFGFGFGFGFGFGFGFFLGFGFGFGFGFGFGFGFCPCPSWWFCHWTBBSWGFGFTRGFSWSWWNSWSWSWBLGFGFCPGFSWCHWTWFWFBBSWGFFLGFGFGFGFGFGFGFGFGFGFGFGFGFGFGFGFGFGFGFGFGFGFGFGFGFCWCWGF
GFCWCWGFGFGFGFGFGFSWSWSWSWSWGFGFCPTRGFGFGFCPGFSWSWWNSWSWSWCRCPGFBLSWSWSWWNSWSWSWGFBLGFGFGFGFGFGFGFGFGFGFGFGFGFGFGFGFGFGFCPCPSWWFWFWFFTSWGFGFGFGFSWFTCRWFTBSWGFGFGFCPGFSWSWSWWNSWSWSWGFTRGFGFGFGFGFGFGFGFGFFLGFGFGFGFGFGFGFGFGFGFGFGFGFGFGFCWCWGF
GFCWCWTRGFGFGFGFGFSWFTWFTBSWGFCPGFGFGFGFGFCPGFSWFTWFWFTBSWGFCPSWSWSWWNSWSWSWGFSWSWSWWNSWSWSWGFGFGFGFGFSWSWSWWNSWSWSWGFGFCPCPSWSWWNSWSWSWGFGFGFGFWNWFWFWFBBWNGFGFGFCPSWSWSWWNSWSWSWGFGFGFGFGFGFGFGFGFTRGFGFGFGFGFGFGFGFGFGFGFGFGFGFGFGFGFTRCWCWGF
TRCWCWGFGFGFGFGFGFSWCHWTBBSWGFCPGFGFGFGFGFCPGFSWWFCHWTBBSWGFCPSWFTWFWFWFTBSWGFSWFTWFWFWFTBSWGFGFGFGFGFSWFTWFWFWFTBSWGFGFCPCPGFGFGFGFGFGFGFGFGFGFSWWFCHWTCHSWGFGFGFCPSWFTWFWFWFTBSWGFGFGFGFTRGFGFGFGFGFTRGFGFGFGFGFGFGFGFGFGFGFGFGFGFGFGFGFCWCWGF
GFCWCWGFGFGFGFGFGFSWWFWFFTSWGFCPFLGFGFFLGFCPGFSWWFWFWFFTSWGFCPSWCHWTWFWFBBSWGFSWCHWTWFWFBBSWGFGFGFGFGFSWCHWTWFWFBBSWBLGFCPCPGFGFGFGFGFGFGFGFTRGFSWBKWFWFFTSWGFGFGFCPSWCHWTWFWFBBSWGFGFGFGFGFGFGFGFGFGFGFGFGFGFGFGFGFGFGFFLGFGFGFGFGFFLGFGFCWCWTR
TRCWCWGFGFGFGFGFGFSWWDSWSWSWGFCPGFGFGFGFGFCPGFSWWDWNSWSWSWGFCPSWWDSWWNSWSWSWGFSWWDSWWNSWSWSWGFGFGFGFGFSWWDSWWNSWSWSWGFGFCPCPFLGFGFCPGFGFGFGFFLGFSWWDWNSWSWSWGFGFGFCPSWWDSWWNSWSWSWGFGFGFFLGFGFGFGFGFGFGFTRGFGFGFGFGFGFGFGFGFGFGFGFGFGFGFGFCWCWGF
GFCWCWTRGFCPCPCPCPCPCPCPCPCPCPCPCPCPCPCPCPCPCPCPCPCPCPCPCPCPCPCPCPCPCPCPCPCPCPCPCPCPCPCPCPCPCPCPCPCPCPCPCPCPCPCPCPCPCPCPCPCPCPCPCPCPCPCPCPCPCPCPCPCPCPCPCPCPCPCPCPCPCPCPCPCPCPGFGFGFGFGFGFGFGFGFGFGFGFGFGFGFGFGFFLFLGFGFGFGFGFGFGFGFGFGFTRCWCWGF
GFCWCWGFGFCRSWWDWNSWSWSWGFGFGFCPGFGFGFGFGFCPGFGFFLGFGFGFGFGFCPSWWDWNSWSWSWGFGFFLGFGFGFFLGFGFGFGFTRGFGFGFGFGFGFSWWDSWSWSWCPCPGFGFGFCPGFGFGFGFGFGFCPGFGFSWWDSWSWSWGFCPGFBLSWWDSWWNSWSWSWGFGFGFGFGFGFGFGFGFGFGFGFGFGFGFGFGFGFGFGFGFGFFLGFGFGFCWCWGF
GFCWCWTRGFGFSWFTWFWFTBSWGFGFGFCPSWSWSWWNSWWDSWGFFLGFGFGFGFFLCPSWFTCRWFTBSWGFGFGFGFGFGFGFGFGFGFGFGFGFGFGFGFGFGFSWFTWFTBSWCPCPGFGFLTCPGFGFGFGFGFLTCPGFGFSWFTWFTBSWGFCPGFGFSWFTWFWFWFTBSWGFGFGFGFGFGFGFGFGFGFGFFLGFGFGFGFGFGFGFGFGFFLGFGFGFTRCWCWGF
GFCWCWGFGFGFSWWFCHWTBBSWGFGFGFCPSWFTWFWFWFTBSWGFGFGFGFGFGFGFCPWNWFWFWFBBWNGFGFGFCPGFGFFLGFGFFLGFGFGFGFFLGFGFGFWNWFWFBBWNCPCPGFGFGFCPSWSWWNSWSWSWCPGFGFSWWFWFBBSWGFCPGFGFSWCHWTWFWFBBSWBLGFGFGFGFFLGFGFGFGFGFGFGFTRGFGFGFGFGFGFGFFLGFGFGFGFCWCWGF
TRCWCWTRGFGFSWWFWFWFFTSWGFFLGFCPSWWFCHWTCHBBSWGFGFGFGFGFGFGFCPSWWFCHWTCHSWGFGFGFCPGFGFGFTRGFGFGFGFGFGFGFGFGFBLSWCHWTCHSWCPCPGFGFGFCPSWFTWFWFTBWDCPGFGFWNCHWTCHWNGFCPGFBLSWSWSWWNSWSWSWGFGFTRGFGFGFGFGFGFGFGFGFGFGFGFGFGFGFGFGFGFGFTRGFGFTRCWCWGF
GFCWCWGFGFGFSWSWWNSWSWSWGFGFGFCPSWWFWFWFWFFTSWGFGFSWSWSWSWSWCPSWBKWFWFFTSWGFGFGFCPGFGFCRGFGFGFGFGFGFGFGFGFGFGFSWWFWFFTSWCPCPGFGFGFCPSWWFCHWTBBSWCPFLGFSWWFWFWFSWGFCPGFGFGFGFGFGFGFGFGFGFGFGFGFGFGFTRFLGFGFGFGFGFGFGFGFGFGFGFGFGFGFGFGFGFGFCWCWGF
FLCWCWGFGFGFGFGFGFGFGFGFGFGFGFCPSWSWSWWNSWSWSWGFGFSWFTWFTBWDCPSWSWWNSWSWSWGFGFGFCPSWSWSWWNSWSWSWGFGFGFGFGFGFGFSWSWSWSWSWCPCPGFFLGFCPSWWFWFWFFTSWCPGFGFSWWFWFFTSWLTCPGFGFGFGFGFGFGFGFGFGFGFGFGFGFGFGFGFGFGFGFGFGFGFGFGFGFGFGFGFGFGFGFGFGFGFCWCWGF
GFCWCWGFGFGFGFTRGFGFGFGFTRGFGFCPGFGFSWSWWNSWSWSWGFWNWFWFBBWNCPGFGFGFBLGFGFGFGFGFCPWDFTWFWFWFTBSWSWSWWNSWSWSWGFGFGFGFGFGFCPCPGFGFGFCPSWSWWNSWSWSWCPGFGFSWSWSWSWSWGFCPGFGFSWSWSWWNSWSWSWGFGFGFGFGFGFGFGFGFGFGFGFGFGFGFGFGFGFGFGFGFGFGFGFGFGFCWCWGF
GFCWCWTRGFGFGFGFGFGFCRGFGFGFGFCPGFGFSWFTWFWFTBSWGFSWCHWTCHSWCPGFGFGFGFGFGFGFGFGFCPSWCHWTWFWFBBSWSWFTWFWFTBSWGFGFGFFLGFGFCPCPGFGFGFCPGFGFGFGFGFGFCPGFGFGFGFGFGFGFGFCPGFGFSWFTWFWFWFTBSWGFGFGFGFGFGFTRGFGFGFGFGFGFGFGFGFGFGFGFGFGFFLGFGFGFTRCWCWGF
GFCWCWGFGFGFGFSWSWSWSWSWGFGFGFCPGFGFSWWFCHWTBBSWGFSWWFWFFTSWGFGFGFGFFLGFGFGFGFGFCPSWSWSWWNSWSWSWSWWFCHWTBBSWGFTRGFFLGFGFCPCPGFGFFLCPGFGFGFGFGFGFCPGFGFGFGFGFGFGFGFCPGFGFSWWFCHWTCHBBSWGFGFGFGFGFGFGFGFGFGFGFGFGFGFGFGFGFGFGFGFGFGFGFGFGFGFCWCWGF
GFCWCWGFGFGFGFSWFTWFTBSWGFGFGFCPGFGFSWWFWFWFFTSWGFSWSWSWSWSWGFGFTRGFGFGFGFGFGFGFCPGFGFGFGFGFGFGFSWWFWFWFFTSWGFGFGFGFGFGFCPCPGFGFGFCPGFGFGFGFGFGFCPGFGFGFGFGFGFGFFLCPGFGFSWWFWFWFWFFTSWGFGFGFGFGFGFTRGFGFGFGFGFGFGFGFFLGFGFGFGFGFGFGFGFGFGFCWCWGF
GFCWCWGFGFGFGFSWCHWTBBSWGFGFTRCPGFGFSWWDWNSWSWSWGFGFGFCRGFGFGFGFGFGFGFGFGFGFGFFLCPGFGFFLGFGFGFGFSWWDWNSWSWSWGFGFGFGFGFGFCPCPGFGFGFCPGFTRGFGFGFGFCPGFGFGFGFFLGFGFGFCPGFGFSWWDSWWNSWSWSWGFGFGFGFGFGFTRGFGFGFGFGFGFGFGFGFGFGFGFGFGFGFGFGFGFGFCWCWGF
GFCWCWTRGFGFGFSWWFWFFTWDCPCPCPCPCPCPCPCPCPCPCPCPCPCPCPCPCPCPCPCPCPCPCPCPCPCPCPCPCPCPCPCPCPCPCPCPCPCPCPCPCPCPCPCPCPCPCPCPCPCPCPCPCPCPCPCPCPCPCPCPCPCPCPCPCPCPCPCPCPCPCPCPCPCPCPCPGFGFCRGFGFGFTRGFGFGFGFGFGFGFGFGFFLGFGFGFGFGFGFGFGFGFGFGFTRCWCWGF
GFCWCWGFFLGFGFSWSWSWSWSWGFGFGFCPLTGFGFSWWDSWSWSWGFGFGFGFGFGFLTGFSWWDSWWNSWSWSWGFCPSWWDSWWNSWSWSWGFGFGFLTGFGFGFDKSNSNRWRWRWRWSNSNDKCPGFGFGFGFLTTRCPGFGFGFLTGFGFGFGFCPGFGFGFSWWDSWSWSWGFGFGFGFGFGFGFGFGFGFGFGFGFGFTRGFGFGFTRGFGFGFGFGFGFGFGFCWCWGF
GFCWCWGFGFGFGFGFGFGFGFGFGFCRGFCPGFGFGFSWFTWFTBSWGFGFGFGFGFGFGFGFSWFTWFWFWFTBSWGFCPSWFTWFWFWFTBSWGFFLGFGFGFGFGFDKDKSNRWRWRWRWSNDKBLGFGFFLGFGFGFGFCPGFGFGFGFGFGFGFGFCPGFGFGFSWFTWFTBSWGFGFGFGFGFGFGFGFGFGFGFGFGFGFGFGFGFGFGFGFGFGFGFGFGFGFGFCWCWFL
GFCWCWGFGFGFGFGFFLGFGFSWSWSWSWWDGFGFGFSWWFWFBBSWCRGFTRGFGFGFGFGFSWWFCHWTCHBBSWGFCPSWCHWTWFWFBBSWGFGFGFGFGFGFGFMKDKSNRWRWRWRWSNDKBNGFGFGFGFGFGFGFCPGFGFGFGFGFGFGFGFCPGFGFGFSWWFWFBBSWGFGFGFGFGFGFGFGFGFGFGFGFGFGFGFGFGFGFGFGFGFGFGFGFGFGFGFCWCWGF
GFCWCWTRGFGFGFFLGFGFGFSWFTWFTBSWGFGFGFWNCHWTCHWNGFGFGFGFGFGFGFGFSWWFWFWFWFFTSWBLCPSWSWSWWNSWSWSWGFGFGFGFGFGFFLGFDKDKSNRWRWRWRWSNDKCRGFGFGFTRGFGFCPSWSWSWWNSWSWSWGFCPGFGFGFWNCHWTCHWNGFGFGFGFGFGFGFGFGFSWSWSWSWSWGFGFGFGFGFFLGFFLGFGFGFGFTRCWCWTR
GFCWCWGFGFGFGFGFGFGFGFWNWFWFBBWNGFGFGFSWWFWFWFSWBLGFSWSWWNSWSWSWSWSWSWWNSWSWSWGFCPBLGFGFGFGFGFGFGFGFGFGFGFGFGFGFDKLTSNRWRWRWRWSNLTDKGFGFGFGFGFGFCPWDFTWFWFWFTBSWGFCPGFGFGFSWWFWFWFSWGFGFGFGFGFGFGFGFGFSWFTCRTBSWGFGFGFGFGFGFGFGFGFGFGFGFGFCWCWGF
TRCWCWGFGFGFGFGFGFFLGFSWCHWTCHSWGFGFGFSWWFWFFTSWGFGFSWFTCRWFTBSWGFGFGFGFGFGFGFGFCPGFGFGFGFGFGFGFGFGFGFGFGFGFGFGFMKDKPLCPCPCPCPPLDKBNGFGFFLGFGFGFCPSWCHWTWFWFBBSWGFCPGFGFGFSWWFWFFTSWGFGFGFGFGFGFGFGFGFSWWFWFBBSWGFGFGFGFGFGFGFGFGFGFGFGFGFCWCWGF
GFCWCWGFGFGFGFGFGFGFGFSWWFWFFTSWGFGFGFSWSWSWSWSWBLCRSWWFWFWFBBSWBLGFGFGFGFGFGFGFCPGFGFTRGFGFGFGFGFGFGFGFGFTRGFGFDKDKSNRWRWRWRWSNDKDKGFGFGFGFGFGFCPSWSWSWWNSWSWSWGFCPGFGFGFSWSWSWSWSWGFGFGFGFGFGFGFGFGFWNWFWFWFWNGFGFGFTRGFGFGFGFGFGFGFGFGFCWCWGF
GFCWCWTRGFGFFLGFGFGFGFSWSWSWSWSWGFGFGFGFBLGFGFCRGFGFWNWFCHWTCHWNGFGFGFGFGFGFFLGFCPGFFLGFGFGFGFGFGFGFGFGFGFGFGFGFDKDKSNRWRWRWRWSNDKDKGFGFGFGFGFGFCPLTGFGFGFGFGFGFGFCPGFGFGFGFGFGFGFGFGFGFGFGFGFGFGFGFCRSWCHWTCHSWGFGFGFGFGFGFGFGFGFGFGFGFTRCWCWTR
GFCWCWGFGFGFGFFLGFGFGFGFGFGFGFGFGFGFGFGFGFFLGFGFGFGFSWWFWFWFWFSWGFGFGFGFGFGFGFTRCPGFGFGFGFGFFLGFGFGFGFGFGFFLGFGFDKLTSNRWRWRWRWSNLTDKGFGFGFFLGFFLGFGFTRFLGFGFGFGFGFCPGFGFGFGFGFGFGFGFGFGFGFGFGFFLGFGFGFSWWFWFWFSWGFGFGFGFGFGFGFGFGFGFGFGFGFCWCWGF
GFCWCWGFTRGFGFGFGFGFGFGFFLGFGFGFGFGFGFGFGFGFGFGFGFGFSWBKWFWFFTSWGFGFGFGFGFGFGFFLCPGFGFGFFLGFGFGFGFGFGFGFGFGFGFGFMKDKSNRWRWRWRWSNDKBNGFGFGFGFGFGFGFGFGFGFGFGFTRGFGFTRTRGFGFGFGFGFGFGFGFFLGFGFGFGFGFGFGFSWBKWFFTSWGFTRGFGFGFGFGFGFTRGFGFGFGFCWCWGF
GFCWCWGFGFTRGFGFGFGFGFGFTRGFGFGFGFGFGFGFGFGFGFGFGFGFSWWDWNSWSWSWGFGFFLGFTRGFGFGFCPGFGFGFGFGFGFGFGFGFGFGFGFGFGFGFDKDKSNRWRWRWRWSNDKDKGFGFGFGFGFGFGFGFGFGFGFGFGFGFGFGFGFFLGFGFGFGFGFGFGFGFGFGFGFGFTRGFGFSWWDSWSWSWGFGFGFGFGFGFGFGFTRGFGFGFGFCWCWGF
GFCWCWTRGFGFGFGFGFGFGFGFGFGFGFGFGFFLGFGFGFGFGFGFCPCPCPCPCPCPCPCPCPCPCPCPCPCPCPCPCPCPCPCPCPCPCPCPCPCPCPCPCPCPCPDKDKSNBTBTRWRWSNDKDKCPCPCPCPCPCPCPCPCPCPCPCPCPCPCPCPCPCPCPCPCPCPCPCPCPCPCPCPCPCPCPCPCPCPCPCPCPCPCPCPCPCPGFGFGFGFGFGFGFGFGFTRCWCWGF
TRCWCWCWGFTRFLFLTRGFGFTRGFGFGFTRGFGFGFTRGFGFTRGFGFTRGFTRGFTRGFTRGFGFGFTRGFGFGFTRGFTRGFGFGFTRGFGFTRGFTRGFGFTRGFBNLTSNRWRWRWRWSNLTMKGFTRGFGFGFTRGFGFTRGFGFGFTRGFTRGFTRGFGFTRGFGFTRGFTRGFGFTRGFGFGFTRGFGFGFTRFLTRGFTRGFGFTRGFTRGFTRGFGFTRGFCWCWCWGF
GFCWCWCWCWCWCWCWCWCWCWCWCWCWCWCWCWCWCWCWCWCWCWCWCWCWCWCWCWCWCWCWCWCWCWCWCWCWCWCWCWCWCWCWCWCWCWCWCWCWCWCWCWCWCWCWCWSNRWRWRWRWSNCWCWCWCWCWCWCWCWCWCWCWCWCWCWCWCWCWCWCWCWCWCWCWCWCWCWCWCWCWCWCWCWCWCWCWCWCWCWCWCWCWCWCWCWCWCWCWCWCWCWCWCWCWCWCWCWGF
TRCWCWCWCWCWCWCWCWCWCWCWCWCWCWCWCWCWCWCWCWCWCWCWCWCWCWCWCWCWCWCWCWCWCWCWCWCWCWCWCWCWCWCWCWCWCWCWCWCWCWCWCWCWCWCWCWSNRWRWRWRWSNCWCWCWCWCWCWCWCWCWCWCWCWCWCWCWCWCWCWCWCWCWCWCWCWCWCWCWCWCWCWCWCWCWCWCWCWCWCWCWCWCWCWCWCWCWCWCWCWCWCWCWCWCWCWCWCWGF
GFGFDKDKDKDKDKDKDKBLDKDKDKDKDKDKDKCRDKDKDKDKDKDKDKBLDKDKDKDKCRDKCRDKDKDKDKDKDKDKDKDKDKDKDKDKDKDKDKDKDKDKDKDKDKDKDKBLCPCPCPCPDKDKDKDKDKDKDKDKDKBLDKDKDKDKDKDKDKDKDKDKDKDKDKDKDKDKDKDKDKDKDKDKDKDKDKDKCRCRDKDKDKDKDKDKDKDKDKDKCRDKDKDKDKDKDKDKGFGF
GFFLDKDKDKDKDKDKDKBLBLDKDKDKDKCRDKDKDKDKDKDKDKDKDKDKDKDKDKDKDKDKDKDKDKCRDKDKDKDKDKDKDKDKDKDKDKDKDKDKDKDKDKDKDKDKDKDKCPCPCPCPDKDKDKDKDKDKDKDKDKDKDKDKDKDKDKCRDKDKDKDKDKBLDKDKDKDKDKDKDKDKCRDKDKDKDKDKDKDKDKDKDKDKDKDKDKDKDKDKDKDKDKDKDKDKBLDKGFTR
GFTRDKDKDKDKDKDKDKDKDKDKDKDKBLDKBLDKDKDKBLDKDKDKDKDKDKDKCRDKDKDKDKDKDKDKBLDKDKDKDKDKDKDKDKDKDKDKDKDKDKDKDKDKDKDKDKDKCPCPCPCPDKDKDKDKDKDKDKDKDKDKDKDKDKDKDKDKDKDKDKDKDKDKBLDKDKDKDKDKDKBLDKDKDKDKBLDKDKDKDKDKDKDKDKDKDKDKDKDKDKDKDKDKDKDKDKDKGFGF
GFGFGFGFPLDKPLSNSNSNSNPLDKPLSNSNSNSNSNPLDKPLRWRWRWRWPLDKPLSNSNSNSNSNPLDKPLSNSNSNPLDKPLSNSNGFGFGFGFGFGFDKGFGFSNSNSNSNCPCPCPCPSNPLDKPLSNSNSNSNPLDKPLRWRWRWRWRWRWSNPLDKPLSNSNSNSNSNSNSNPLDKPLSNSNGFGFGFGFGFGFDKGFGFSNSNSNSNSNSNPLDKPLSNSNSNSNSNSNSN
SNSNSNSNPLDKPLRWRWRWRWPLDKPLRWRWRWRWRWPLDKPLRWRWRWRWPLDKPLRWRWRWRWRWPLDKPLRWRWRWPLDKPLRWRWSNSNSNSNSNPLDKPLSNRWRWRWRWRWRWRWRWRWPLDKPLRWRWRWRWPLDKPLRWRWRWRWRWRWRWPLDKPLRWRWRWRWRWRWRWPLDKPLRWRWSNSNSNSNSNPLDKPLSNRWRWRWRWRWRWPLDKPLRWRWRWRWRWRWRW
RWRWRWRWPLDKPLRWRWRWRWPLDKPLRWRWRWRWRWPLDKPLRWRWRWRWPLDKPLRWRWRWRWRWPLDKPLRWRWRWPLDKPLRWRWRWRWRWRWRWPLDKPLRWRWRWRWRWRWRWRWRWRWPLDKPLRWRWRWRWPLDKPLRWRWRWRWRWRWRWPLDKPLRWRWRWRWRWRWRWPLDKPLRWRWRWRWRWRWRWPLDKPLRWRWRWRWRWRWRWPLDKPLRWRWRWRWRWRWRW
RWRWRWRWRWRWRWRWRWRWRWRWRWRWRWRWRWRWRWRWRWRWRWRWRWRWRWRWRWRWRWRWRWRWRWRWRWRWRWRWRWRWRWRWRWRWRWRWRWRWRWRWRWRWRWRWRWRWRWRWRWRWRWRWRWRWRWRWRWRWRWRWRWRWRWRWRWRWRWRWRWRWRWRWRWRWRWRWRWRWRWRWRWRWRWRWRWRWRWRWRWRWRWRWRWRWRWRWRWRWRWRWRWRWRWRWRWRWRWRW
RWRWRWRWRWRWRWRWRWRWRWRWRWRWRWRWRWRWRWRWRWRWRWRWRWRWRWRWRWRWRWRWRWRWRWRWRWRWRWRWRWRWRWRWRWRWRWRWRWRWRWRWRWRWRWRWRWRWRWRWRWRWRWRWRWRWRWRWRWRWRWRWRWRWRWRWRWRWRWRWRWRWRWRWRWRWRWRWRWRWRWRWRWRWRWRWRWRWRWRWRWRWRWRWRWRWRWRWRWRWRWRWRWRWRWRWRWRWRWRW
