GFGFGFTRGFGFGFGFGFTRTRGFGFGFGFGFGFGFGFGFGFGFGFFLGFGFTRGFGFGFGFGFTRGFGFGFGFGFGFGFGFGFGFGFGFGFFLGFGFGFGFGFGFGFGFGFGFGFGFGFGFGFGFGFGFGFGFFLGFGFGFGFGFGFGFGFGFGFGFGFGFGFGFTRGFGFGFGFGFGFTRGFGFGFGFGFGFGFGFGFGFGFGFGFGFGFGFGFGFGFGFGFGFGFGFGFGFTRGFTR
GFCWCWCWCWCWCWCWCWCWCWCWCWCWCWCWCWCWCWCWCWCWCWCWCWCWCWCWCWCWCWCWCWCWCWCWCWCWCWCWCWCWCWCWCWCWCWCWCWCWCWCWCWCWCWCWCWCWCWCWCWCWCWCWCWCWCWCWCWCWCWCWCWCWCWCWCWCWCWCWCWCWCWCWCWCWCWCWCWCWCWCWCWCWCWCWCWCWCWCWCWCWCWCWCWCWCWCWCWCWCWCWCWCWCWCWCWCWCWGF
GFCWCWCWCWCWCWCWCWCWCWCWCWCWCWCWCWCWCWCWCWCWCWCWCWCWCWCWCWCWCWCWCWCWCWCWCWCWCWCWCWCWCWCWCWCWCWCWCWCWCWCWCWCWCWCWCWCWCWCWCWCWCWCWCWCWCWCWCWCWCWCWCWCWCWCWCWCWCWCWCWCWCWCWCWCWCWCWCWCWCWCWCWCWCWCWCWCWCWCWCWCWCWCWCWCWCWCWCWCWCWCWCWCWCWCWCWCWCWGF
TRCWCWCWGFTRGFGFTRGFGFTRGFTRGFTRGFGFGFTRGFGFCRTRGFGFTRGFTRGFGFGFTRGFTRGFGFTRGFGFTRGFTRBLLTCPCPCPCPCPCPCPCPCPCPCPCPCPCPCPCPCPCPCPCPCPCPCPCPCPCPCPCPCPCPCPGFTRGFGFTRGFGFTRGFGFFLTRTRGFTRGFTRGFTRGFGFTRGFTRGFTRBLGFTRCRTRGFGFTRGFTRGFTRTRGFCWCWCWGF
GFCWCWGFGFGFGFGFGFGFGFGFGFFLFLGFGFGFGFGFGFSWSWSWSWSWGFGFGFGFGFGFGFGFGFGFGFGFGFGFSWSWSWSWSWCPLTCPCPCPCPCPCPCPCPCPCPCPCPCPCPCPCPCPCPCPCPCPCPCPCPCPCPCPLTCPGFGFGFGFGFGFGFGFGFGFGFGFGFGFGFGFGFGFGFGFGFGFGFGFGFSWSWWNSWSWSWGFFLGFGFGFGFGFGFGFGFCWCWGF
GFCWCWGFGFGFGFGFGFGFGFGFFLGFGFFLGFGFGFGFGFSWFTWFTBWDCPCPGFGFGFGFGFGFGFGFGFGFGFGFSWFTWFTBWDCPCPSWSWSWSWSWSWSWSWSWSWSWSWWNWNWNSWSWSWSWSWSWSWSWSWSWSWSWCPCPGFGFGFGFGFGFGFGFGFGFGFGFGFGFGFGFGFGFGFGFGFGFGFGFGFSWFTCRWFTBSWGFGFGFGFGFGFGFGFGFGFCWCWGF
GFCWCWGFGFGFGFGFGFGFGFGFGFGFGFGFGFGFGFGFGFSWCHWTBBSWCPCPTRGFGFGFGFGFGFGFGFFLGFGFSWCHWTBBSWCPCPSWSFSFSFSFSFSFSFSFSFSFSFSFSFSFSFSFSFSFSFSFSFSFSFSFSFSWCPCPTRGFGFGFGFGFFLGFGFFLGFGFFLGFGFGFGFGFGFGFGFGFGFGFGFSWWFWFWFBBSWGFFLGFGFGFGFGFGFGFGFCWCWGF
TRCWCWTRGFGFGFGFGFGFGFGFGFGFGFGFCRGFGFGFGFSWWFWFFTSWCPCPGFGFGFGFGFGFGFGFGFGFGFGFSWWFWFFTSWCPCPWNSFSFSFSFSFSFSFSFSFSFGAFTALFTGASFSFSFSFSFSFSFSFSFSFWNCPCPGFGFGFGFGFGFGFTRGFGFGFTRGFGFGFGFGFGFGFGFGFGFGFGFGFWNWFCHWTCHWNGFGFGFGFGFGFGFGFGFTRCWCWGF
GFCWCWGFGFGFGFGFGFGFGFGFGFGFGFSWSWWNSWSWSWSWSWSWSWSWCPCPGFGFGFGFGFGFGFGFGFFLGFGFSWSWSWSWSWCPCPSWFTSFSFSFSFSFSFSFSFSFSFSFCHSFSFSFSFSFSFSFSFSFSFSFFTSWCPCPSWSWWNSWSWSWBLGFGFGFGFGFGFGFGFGFGFGFGFGFGFGFGFFLGFSWWFWFWFWFSWGFGFGFGFTRGFGFGFGFGFCWCWGF
GFCWCWTRGFGFFLGFGFGFBLGFGFGFGFSWFTCRWFTBSWGFGFGFGFGFCPCPSWSWSWWNSWSWSWGFGFGFGFGFSWSWSWSWSWCPCPWNSFPWPWPWPWPWPWPWPWPWPWSFSFSFPWPWPWPWPWPWPWPWPWPWSFWNCPCPWDFTWFWFTBSWGFGFGFGFGFGFGFGFGFGFGFGFGFGFGFGFGFGFGFSWBKWFWFFTSWGFGFGFFLGFGFGFGFGFTRCWCWGF
GFCWCWGFGFGFGFGFGFSWSWWNSWSWSWWNWFWFWFBBWNSWSWSWSWSWCPCPWDFTWFWFWFTBSWGFFLGFGFGFSWFTWFTBWDCPCPSWSFPWPWPWPWPWPWPWPWPWPWSFSFSFPWPWPWPWPWPWPWPWPWPWSFSWCPCPSWWFCHWTBBSWGFGFGFGFGFGFSWSWSWWNSWSWSWCRGFGFGFGFGFSWSWWDSWSWSWGFGFGFGFGFGFGFGFGFGFCWCWGF
GFCWCWGFGFGFGFGFGFSWFTWFWFTBSWSWWFCHWTCHSWSWFTWFTBSWCPCPSWWFCHWTCHBBSWGFGFGFTRGFSWCHWTBBSWCPCPWNFTSFSFSFSFSFSFSFSFSFSFSFSFSFSFSFSFSFSFSFSFSFSFSFFTWNCPCPSWWFWFWFFTSWGFGFGFGFGFGFSWFTWFWFWFTBSWGFGFGFGFGFGFGFBLCPGFGFGFGFGFGFGFGFGFTRGFGFGFCWCWGF
TRCWCWGFTRGFGFTRBLSWWFCHWTBBSWSWBKWFWFFTSWSWCHWTBBSWCPCPSWWFWFWFWFFTSWGFGFGFGFGFSWWFWFFTSWCPCPSWSFPWPWPWPWPWPWPWPWPWPWSFSFSFPWPWPWPWPWPWPWPWPWPWSFSWCPCPSWSWWNSWSWSWGFGFGFGFGFBLSWWFCHWTCHBBSWGFSWSWSWSWSWGFGFCPTRGFGFGFTRGFGFGFGFGFGFGFGFCWCWGF
GFCWCWTRTRGFGFGFGFSWWFWFWFFTSWSWSWWDSWSWSWSWWFWFFTSWCPCPSWSWSWWNSWSWSWGFGFGFGFGFSWSWSWSWSWCPCPWNSFPWPWPWPWPWPWPWPWPWPWSFSFSFPWPWPWPWPWPWPWPWPWPWSFWNCPCPCRGFGFLTGFGFGFGFGFGFGFGFSWWFWFWFWFFTSWGFSWFTWFTBSWGFGFCPGFGFGFGFFLGFFLGFGFFLTRGFTRCWCWGF
GFCWCWGFGFGFGFFLGFSWSWWNSWSWWDCRGFCPGFGFGFSWWDSWSWSWCPCPGFGFGFGFCRGFGFGFGFGFGFGFGFGFGFGFGFCPCPSWFTSFSFSFSFSFSFSFSFSFSFSFSFSFSFSFSFSFSFSFSFSFSFSFFTSWCPCPGFGFGFCPCPCPCPGFGFTRGFGFSWWDSWWNSWSWSWGFWNWFWFBBWNGFGFCPGFGFGFFLGFGFFLGFGFGFGFGFGFCWCWFL
GFCWCWTRGFFLGFGFGFGFGFGFGFGFCPCPCPCPCPCPCPCPCPCPCPCPCPCPCPCPCPCPCPCPCPCPCPCPCPCPCPCPCPCPCPCPCPWNSFPWPWPWPWPWPWPWPWPWPWSFSFSFPWPWPWPWPWPWPWPWPWPWSFWNCPCPCPCPCPCPCPCPCPCPCPCPCPCPCPCPCPCPCPCPCPCPWDCHWTCHSWBLGFCPGFGFGFGFGFGFGFGFGFGFGFGFTRCWCWFL
GFCWCWGFGFGFGFGFGFGFGFGFGFGFFLGFGFCPGFGFGFGFGFGFGFGFCPCPGFGFGFGFGFGFGFGFGFGFSWWDSWSWSWGFGFCPCPSWSFPWPWPWPWPWPWPWPWPWPWSFSFSFPWPWPWPWPWPWPWPWPWPWSFSWCPCPSWWDWNSWSWSWSWWDSWSWSWGFGFGFGFCPGFFLGFGFSWWFWFFTSWGFGFCPSWSWSWSWSWGFGFGFGFGFGFGFFLCWCWGF
TRCWCWGFGFGFGFGFGFGFGFGFGFGFGFGFGFCPGFGFGFGFGFGFGFFLCPCPGFGFGFGFGFGFGFGFGFGFSWFTWFTBSWGFGFCPCPWNFTSFSFSFSFSFSFSFSFSFSFSFSFSFSFSFSFSFSFSFSFSFSFSFFTWNCPCPSWFTCRWFTBSWSWFTWFTBSWGFGFGFGFCPGFGFGFGFSWSWSWSWSWGFGFCPWDFTWFTBSWGFGFGFTRGFGFGFTRCWCWGF
GFCWCWGFGFGFGFGFGFGFSWSWSWWNSWSWSWCPGFGFGFGFGFGFGFTRCPGFBLGFGFGFGFFLGFGFGFGFWNWFWFBBWNGFGFCPCPSWSFPWPWPWPWPWPWPWPWPWPWSFSFSFPWPWPWPWPWPWPWPWPWPWSFSWCPCPWNWFWFWFBBWNSWWFWFBBSWGFGFGFGFCPGFGFGFGFGFGFGFGFGFGFGFCPSWCHWTBBSWGFGFGFGFGFGFGFGFCWCWGF
GFCWCWTRGFGFGFGFGFGFSWFTWFWFWFTBWDCPGFGFGFGFCRGFGFGFCPSWSWSWSWSWCRGFGFGFGFGFSWCHWTCHSWCRGFCPCPWNSFSFSFSFSFSFSFSFSFSFSFSFSFSFSFSFSFSFSFSFSFSFSFSFSFWNCPCPSWWFCHWTCHSWWNCHWTCHWNGFGFGFGFCPGFGFGFGFBLSWSWSWSWSWGFCPSWWFWFFTSWGFGFGFGFGFGFGFTRCWCWGF
GFCWCWGFGFGFGFGFGFBLSWCHWTWFWFBBSWCPGFSWSWSWSWSWGFGFCPSWFTWFTBSWGFGFGFGFGFGFSWWFWFFTSWGFGFCPCPSWFTSFSFSFSFSFSFSFSFSFSFSFSFSFSFSFSFSFSFSFSFSFSFSFFTSWCPCPSWBKWFWFFTSWSWWFWFWFSWGFGFGFGFCPGFGFGFGFGFSWFTWFTBSWCRCPSWSWSWSWSWGFGFGFGFGFGFGFGFCWCWTR
GFCWCWFLGFGFGFGFGFGFSWSWSWWNSWSWSWGFGFSWFTWFTBSWGFGFCPSWCHWTBBSWGFGFGFGFGFGFSWSWSWSWSWGFGFCPCPWNSFSFSFSFSFSFSFSFSFSFSFSFSFSFSFSFSFSFSFSFSFSFSFSFSFWNCPCPSWSWWNSWSWSWSWWFWFFTSWGFGFCPGFCPGFGFGFGFGFSWCHWTBBSWGFCPGFCRGFGFGFGFGFGFGFGFGFGFGFCWCWGF
GFCWCWGFGFGFGFGFGFGFGFGFSWSWSWSWSWGFGFSWCHWTBBSWGFGFCPSWWFWFFTSWGFGFGFGFGFGFGFGFCRGFGFGFGFCPCPSWSFSFSFSFSFSFSFSFSFSFSFSFSFSFSFSFSFSFSFSFSFSFSFSFSFSWCPCPGFGFGFGFGFGFSWSWSWSWSWGFGFCPGFCPGFGFGFGFGFSWWFWFFTSWGFCPFLGFTRGFGFGFGFGFGFGFGFGFGFCWCWGF
GFCWCWTRGFGFGFGFGFGFGFGFSWFTCRTBSWGFGFSWWFWFFTSWGFGFCPSWWDSWSWSWGFGFGFLTGFGFGFGFGFLTGFGFGFCPCPSWSWSWSWSWSWSWSWSWSWSWSWSWWDSWSWSWSWSWSWSWSWSWSWSWSWSWCPCPGFLTGFGFGFGFGFGFGFLTGFGFGFCPLTCPGFGFGFGFLTSWWDSWSWSWGFCPLTGFGFGFGFGFGFGFLTGFGFGFTRCWCWGF
GFCWCWFLGFGFGFGFGFGFGFGFSWWFWFBBSWGFGFSWSWSWSWWDCPCPCPCPCPCPCPCPCPCPCPCPCPCPCPCPCPCPCPCPCPCPLTCPCPCPCPCPCPCPCPCPCPFOCPCPCPCPCPFOCPCPCPCPCPCPCPCPCPCPLTCPCPCPCPCPCPCPCPCPCPCPCPCPCPCPCPCPCPCPCPCPCPCPCPCPCPCPCPCPCPCPCPCPCPCPCPCPCPGFGFGFGFCWCWGF
FLCWCWGFGFGFGFGFGFGFGFGFWNWFWFWFWNGFGFSWSWSWWNSWSWSWCPGFGFGFGFGFGFGFGFGFGFGFGFGFGFGFGFGFGFCPCPCPCPCPCPCPCPCPCPCPCPCPCPCPCPCPCPCPCPCPCPCPCPCPCPCPCPCPCPCPGFGFSWSWSWWNSWSWSWGFGFGFGFCPGFCPGFTRGFGFGFGFGFGFGFGFGFCPGFGFGFTRGFGFGFGFFLGFGFGFGFCWCWGF
GFCWCWTRTRGFGFGFGFFLGFGFSWCHWTCHSWGFGFSWFTWFWFWFTBSWCPGFGFGFGFGFGFGFGFTRGFGFGFGFGFGFGFGFTRGFGFGFGFFLGFGFGFGFCPGFGFGFGFGFCPCPGFGFGFGFGFGFCPCPGFGFGFCPCPGFGFGFSWFTWFWFWFTBSWGFGFGFGFCPGFCPGFGFGFGFFLGFGFFLGFGFGFCPFLGFTRGFGFGFGFGFGFGFGFGFTRCWCWGF
GFCWCWGFGFGFGFGFGFGFGFGFSWWFWFWFSWGFGFSWCHWTWFWFBBSWGFGFGFGFGFGFTRGFGFGFGFTRGFGFGFGFGFGFGFGFGFGFGFGFGFGFGFTRCPCPCPCPCPCPCPCPCPCPCPCPGFGFCPCPGFGFGFCPCPGFGFGFSWCHWTWFWFBBSWGFGFGFGFCPTRCPGFGFGFGFGFGFGFGFGFGFGFCPGFGFGFGFGFGFGFGFGFGFGFGFGFCWCWGF
GFCWCWGFGFGFGFGFGFGFGFGFSWBKWFFTSWGFGFSWWDSWWNSWSWSWGFGFGFGFGFGFGFGFGFTRGFGFGFGFGFGFGFGFGFGFGFGFGFGFGFGFGFGFCPGFGFLTCPCPCPCPCPLTGFGFGFTRCPCPGFGFGFCPCPGFGFGFSWWDSWWNSWSWSWGFGFGFGFCPGFCPGFGFGFGFGFGFGFGFGFGFCPCPGFGFGFGFGFGFGFGFGFGFGFGFGFCWCWTR
GFCWCWGFGFGFGFGFGFGFGFGFSWSWSWSWWDCPCPCPCPCPCPCPCPCPCPCPCPCPCPCPCPCPCPCPCPCPCPCPCPCPCPCPCPCPCPCPCPCPCPCPCPCPCPCPCPCPCPCPCPCPCPCPCPCPCPCPCPCPCPCPCPCPCPCPCPCPCPCPCPCPCPCPCPCPCPCPCPCPCPCPCPCPCPCPCPCPCPCPCPCPCPCPCPCPCPCPCPCPCPCPCPCPCPGFGFCWCWGF
FLCWCWTRGFGFGFGFGFGFGFGFGFSWSWSWWNWDSWSWGFSWWDSWWNSWSWSWGFGFSWWDWNSWSWSWGFSWWDSWWNSWSWSWLTGFTRGFFLLTGFGFGFGFCPGFCPCPCPCPCPCPCPCPCPGFFLGFCPCPGFGFGFLTGFGFGFGFSWWDSWSWSWGFGFGFGFGFLTCPGFCPGFFLLTGFGFGFGFLTGFGFCPCPCPGFLTGFGFCPGFGFLTGFGFGFTRCWCWGF
GFCWCWGFGFGFGFGFGFGFGFGFGFSWFTWFWFWFTBSWGFSWFTWFWFWFTBSWGFGFSWFTCRWFTBSWGFSWFTWFWFWFTBSWGFGFGFGFGFGFGFGFFLGFCPGFCPCPCPCPWLCPCPCPCPGFMKGFCPCPSWSWSWWNSWSWSWGFSWFTWFTBSWGFGFCRGFGFGFCPGFCPGFGFGFGFBLGFGFGFGFGFCPCPCPGFGFGFGFCPGFGFGFGFGFGFGFCWCWGF
GFCWCWTRGFGFGFGFGFGFGFGFGFSWCHWTWFWFBBSWGFSWCHWTWFWFBBSWGFGFWNWFWFWFBBWNGFSWCHWTWFWFBBSWGFGFGFGFGFGFGFGFGFGFCPGFCPCPCPCPCPCPCPCPCPGFGFGFCPCPWDFTWFWFWFTBSWGFSWCHWTBBSWSWSWSWSWSWGFCPGFCPSWSWSWWNSWSWSWGFGFGFCPCPCPGFGFGFGFCPGFGFGFGFGFGFTRCWCWTR
GFCWCWFLGFGFGFGFGFGFGFGFGFSWSWSWWNSWSWSWCRSWSWSWWNSWSWSWGFGFSWWFCHWTCHSWCRSWSWSWWNSWSWSWGFGFSWSWWNSWSWSWGFGFCPGFCPCPCPCPCPCPCPCPCPGFGFGFGFCPSWCHWTWFWFBBSWGFSWWFWFFTSWSWFTCRTBSWGFCPGFCPWDFTWFWFWFTBSWGFGFGFCPCPCPGFGFGFGFCPGFGFGFGFGFFLGFCWCWFL
GFCWCWTRGFGFGFGFGFGFGFGFGFGFCRGFGFGFGFGFGFGFGFGFGFGFGFGFGFGFSWBKWFWFFTSWGFGFGFGFGFSWSWSWSWSWSWFTCRWFTBSWGFGFCPGFGFLTCPCPCPCPCPLTGFGFGFGFGFCPSWSWSWWNSWSWSWGFSWSWSWSWSWSWWFWFBBSWGFCPGFCPSWCHWTWFWFBBSWGFGFGFCPCPCPGFGFGFGFCPGFGFGFGFGFTRTRCWCWGF
GFCWCWGFGFGFGFGFFLGFGFGFGFGFGFGFGFFLGFFLGFGFFLFLGFGFGFFLGFGFSWSWWNSWSWSWGFGFGFTRCRSWFTWFTBSWWNWFWFWFBBWNSWSWWNSWSWSWCPCPCPCPCPGFGFGFGFGFGFCPGFGFGFGFGFGFGFGFGFGFGFGFGFWNWFWFWFWNGFCPGFCPSWSWSWWNSWSWSWGFGFGFCPCPCPGFGFGFGFCPGFGFTRGFGFGFGFCWCWGF
TRCWCWGFGFGFGFGFTRGFGFGFGFGFGFGFGFGFGFFLGFGFGFGFGFFLGFGFGFGFGFCRGFBLBLGFGFGFGFGFGFWNWFWFBBWNSWWFCHWTCHSWSWFTWFWFTBSWGFGFCPCPGFGFGFTRGFGFGFCPTRGFGFGFGFGFGFGFGFGFGFGFGFSWCHWTCHSWGFCPGFCPBLGFGFGFGFGFGFGFGFGFCPCPCPGFGFGFGFCPGFGFFLGFGFGFGFCWCWGF
GFCWCWTRGFGFGFGFGFGFGFGFGFGFGFGFGFGFGFGFGFGFGFGFGFGFGFGFGFGFGFSWSWSWSWSWGFGFGFGFGFSWCHWTCHSWSWBKWFWFFTSWSWWFCHWTBBSWBLGFCPCPGFGFGFGFGFGFGFCPGFGFFLGFGFGFGFGFGFGFGFGFGFSWWFWFWFSWGFCPGFCPLTGFGFGFGFGFGFGFGFGFCPCPCPGFGFGFGFCPGFGFGFGFGFGFTRCWCWGF
GFCWCWFLGFGFGFGFGFGFGFGFGFGFGFGFGFGFGFGFGFGFGFGFGFGFGFGFGFGFGFSWFTWFTBSWGFGFGFGFGFSWWFWFFTSWSWSWWDSWSWSWSWWFWFWFFTSWGFGFCPCPGFGFGFFLGFGFGFCPGFGFGFGFGFGFGFGFGFGFGFGFGFSWBKWFFTSWGFCPGFCPGFGFTRGFGFGFGFGFGFGFCPGFCPGFGFGFGFCPGFGFGFTRGFGFGFCWCWGF
GFCWCWTRGFGFGFGFFLGFFLGFGFGFGFGFGFGFGFGFGFGFGFGFGFGFGFGFFLGFGFSWCHWTBBSWGFGFGFGFGFSWWDSWSWSWGFGFCPGFGFGFSWWDWNSWSWSWGFGFCPCPGFGFGFTRGFGFGFCPTRGFFLGFGFGFGFGFGFGFGFGFGFSWWDSWSWSWGFCPGFCPGFGFGFFLGFGFGFGFGFGFCPGFCPGFGFGFGFCPGFGFGFGFGFGFTRCWCWGF
GFCWCWGFGFGFGFGFGFGFGFGFGFGFGFGFGFGFGFGFGFGFGFGFGFGFGFGFGFGFGFSWWFWFFTWDCPCPCPCPCPCPCPCPCPCPCPCPCPCPCPCPCPCPCPCPCPCPCPCPCPCPCPCPCPCPCPCPCPCPCPCPCPCPCPCPCPCPCPCPCPCPCPCPCPCPCPCPCPCPCPCPCPCPCPCPCPCPCPCPCPCPCPCPCPCPCPCPCPCPCPCPCPCPCPGFGFCWCWGF
GFCWCWTRGFGFGFGFGFFLGFGFGFGFGFGFGFGFGFGFGFGFGFGFGFFLGFTRGFGFBLSWSWSWSWSWGFGFGFGFGFGFGFGFGFGFGFGFCPGFGFGFGFGFGFGFGFGFGFGFCPCPGFGFGFGFGFFLGFCPGFSWWDSWSWSWGFSWWDSWWNSWSWSWGFGFGFGFGFCPGFCPGFGFSWWDSWSWSWGFGFGFCPGFGFGFFLGFGFCPGFGFGFGFTRGFTRCWCWGF
GFCWCWGFGFGFGFGFGFFLGFGFGFGFGFGFGFGFGFGFGFGFGFGFGFGFGFGFGFSWSWSWSWSWGFGFGFGFGFGFGFGFGFGFGFGFGFGFCPGFGFGFGFGFGFBLGFGFGFGFCPCPGFGFGFGFGFGFTRGFGFSWFTWFTBSWGFSWFTWFWFWFTBSWGFGFGFGFGFCPGFCPLTGFSWFTWFTBSWGFGFGFCPGFGFGFGFGFGFCPGFGFGFGFGFGFGFCWCWTR
GFCWCWGFGFGFGFGFGFGFGFGFGFGFGFGFGFGFGFGFGFGFGFGFGFGFGFGFGFSWFTCRTBSWGFFLCRSWSWSWSWSWSWSWWNSWSWSWCPGFGFGFGFGFSWSWWNSWSWSWCPCPGFGFGFGFGFGFGFGFGFSWCHWTBBSWGFSWCHWTWFWFBBSWSWSWSWSWSWCPGFCPGFGFWNWFWFBBWNGFGFGFCPGFGFGFGFGFGFCPGFFLGFGFGFGFGFCWCWGF
GFCWCWGFGFGFGFGFGFGFGFGFGFGFGFGFGFGFGFGFTRGFGFGFGFGFGFGFGFSWWFWFBBSWGFGFGFSWFTWFTBSWSWFTWFWFTBWDCPGFGFGFGFGFSWFTWFWFTBWDCPCPGFCRSWSWSWSWSWGFCRSWWFWFFTSWGFSWSWSWWNSWSWSWSWFTWFTBSWCPGFCPGFGFSWCHWTCHSWGFGFGFCPGFGFGFGFGFGFCPGFGFGFGFGFGFGFCWCWGF
GFCWCWTRGFGFGFGFGFGFGFGFGFFLGFGFGFFLGFGFGFGFGFGFGFFLGFGFGFWNWFWFWFWNGFGFGFSWWFWFBBSWSWWFCHWTBBSWCPSWSWSWSWSWSWWFCHWTBBSWCPCPGFGFSWFTWFTBSWGFGFSWSWSWSWSWGFSWSWWNSWSWSWBLSWWFWFBBSWCPGFGFGFGFSWWFWFFTSWGFGFGFCPSWSWWNSWSWSWCPGFFLGFGFGFGFTRCWCWGF
TRCWCWGFGFGFFLGFFLGFGFGFGFGFGFGFGFGFGFGFGFGFGFGFGFGFGFGFGFSWCHWTCHSWGFGFGFWNCHWTCHWNSWWFWFWFFTSWCPSWFTWFTBSWSWWFWFWFFTSWCPCPGFGFWNWFWFBBWNGFGFGFGFGFGFGFGFSWFTWFWFTBSWGFWNCHWTCHWNCPGFGFGFGFSWSWSWSWSWGFGFGFCPSWFTWFWFTBSWCPGFGFGFGFTRGFGFCWCWGF
GFCWCWTRGFGFGFGFGFGFGFGFGFGFGFGFGFGFGFGFGFGFGFGFGFTRGFGFGFSWWFWFWFSWGFTRGFSWWFWFWFSWSWSWWNSWSWSWCPSWCHWTBBSWSWSWWNSWSWSWCPCPGFGFSWCHWTCHSWGFGFGFGFGFTRGFGFSWWFCHWTBBSWGFSWWFWFWFSWCPGFGFGFGFGFCRGFGFGFGFGFGFCPSWWFCHWTBBSWCPGFGFGFGFGFGFTRCWCWGF
GFCWCWGFGFGFGFFLGFGFGFTRGFTRGFGFGFGFGFGFGFGFGFGFTRGFGFTRGFSWBKWFFTSWGFGFGFSWWFWFFTSWGFGFGFGFGFGFCPSWWFWFFTSWGFGFGFGFGFGFCPCPGFGFSWWFWFFTSWGFGFGFGFGFGFGFGFSWWFWFWFFTSWGFSWWFWFFTSWGFFLGFGFFLFLGFTRGFGFGFGFGFCPSWWFWFWFFTSWCPGFGFGFGFTRGFGFCWCWGF
GFCWCWGFGFGFGFGFGFGFGFGFGFGFGFSWSWSWWNSWSWSWGFLTFLFLGFGFGFSWWDSWSWSWGFGFGFSWWDSWSWSWLTGFGFGFGFGFCPSWWDSWSWSWGFGFLTGFGFGFCPCPGFGFSWWDSWSWSWLTGFGFGFGFGFGFGFSWWDWNSWSWSWGFSWWDSWSWSWLTGFGFGFGFLTGFGFGFFLLTGFGFCPSWWDWNSWSWSWCPLTGFGFGFGFGFGFCWCWGF
FLCWCWGFFLGFGFGFGFGFGFGFGFGFGFSWFTWFWFWFTBWDCPCPCPCPCPCPCPCPCPCPCPCPCPCPCPCPCPCPCPCPCPCPCPCPCPCPCPCPCPCPCPCPCPCPCPCPCPCPCPCPCPCPCPCPCPCPCPCPCPCPCPCPCPCPCPCPCPCPCPCPCPCPCPCPCPCPCPCPCPCPCPCPCPCPCPCPCPCPCPCPCPCPCPCPCPCPCPCPCPCPCPCPCPGFGFCWCWGF
TRCWCWTRGFGFGFGFGFGFGFGFGFGFGFSWCHWTWFWFBBSWSWSWSWSWSWGFGFGFGFGFGFGFSWWDSWWNSWSWSWGFGFGFGFGFGFGFCPSWWDSWSWSWGFGFGFGFGFGFCPCPGFGFGFGFGFGFGFGFGFGFGFSWWDSWWNSWSWSWSWWDWNSWSWSWGFGFGFGFGFGFGFGFGFGFSWWDSWSWSWGFCPGFGFGFGFGFCRCPGFGFGFGFGFGFTRCWCWGF
GFCWCWGFGFGFGFGFGFGFGFGFGFGFGFSWSWSWWNSWSWSWSWFTCRTBSWGFGFGFGFGFGFGFSWFTWFWFWFTBSWGFGFGFGFGFGFGFCPSWFTWFTBSWDKDKSNRWRWRWRWSNSNSNGFGFGFGFGFGFGFFLGFSWFTWFWFWFTBSWSWFTWFWFTBSWGFGFGFGFGFGFGFGFGFGFSWFTWFTBSWCRCPGFSWSWSWSWSWCPGFGFGFGFGFGFTRCWCWTR
GFCWCWTRGFGFGFGFGFGFGFGFGFGFGFGFGFGFGFGFGFGFSWWFWFBBSWGFGFGFGFGFGFGFSWCHWTWFWFBBSWGFGFGFGFGFTRGFCPSWWFWFBBSWDKDKSNRWRWRWRWSNDKDKGFGFGFGFGFGFGFGFGFSWCHWTWFWFBBSWSWWFCHWTBBSWGFGFGFGFGFGFGFGFGFGFSWCHWTBBSWGFCPGFSWFTWFTBWDCPGFGFGFGFGFGFTRCWCWGF
GFCWCWGFTRFLGFGFGFGFGFFLGFGFGFGFGFGFGFTRGFGFWNWFWFWFWNGFGFGFGFFLGFGFSWSWSWWNSWSWSWBLFLGFGFGFGFGFCPWNCHWTCHWNDKLTSNRWRWRWRWSNLTDKGFGFGFSWSWWNSWSWSWSWSWSWWNSWSWSWSWWFWFWFFTSWGFGFGFGFGFGFGFGFGFGFSWWFWFFTSWLTCPGFSWCHWTBBSWGFGFGFGFGFGFGFGFCWCWGF
GFCWCWGFGFGFGFGFGFGFGFGFGFGFGFGFGFGFGFGFGFGFSWCHWTCHSWGFGFGFGFGFGFGFGFGFGFGFBLGFGFGFGFGFGFGFGFFLCPSWWFWFWFSWGFDKDKSNRWRWRWRWSNDKDKGFGFSWFTWFWFFGSWGFGFGFGFGFGFGFSWSWWNSWSWSWGFGFGFGFGFGFGFGFGFBLSWSWSWSWSWGFGFBLSWWFWFFTSWGFGFGFGFGFGFGFGFCWCWGF
FLCWCWGFGFGFGFGFGFTRGFGFGFGFGFFLGFGFGFGFGFGFSWWFWFWFSWGFGFGFGFGFTRGFGFGFGFGFGFGFGFGFGFGFGFGFGFGFCPSWWFWFFTSWBLMKDKPLCPCPCPCPPLDKBNGFGFSWWFCHWTFGSWGFGFGFGFGFGFGFGFGFGFGFGFGFGFGFGFGFGFGFGFGFGFGFGFGFGFGFGFGFGFGFSWSWSWSWSWCRGFGFGFGFGFFLGFCWCWGF
GFCWCWTRGFGFGFGFGFGFGFTRGFGFGFGFGFGFGFGFGFGFSWBKWFFTSWGFGFGFGFGFGFGFGFGFGFGFGFGFGFGFGFGFGFGFGFGFCPSWSWSWSWSWGFDKDKSNRWRWRWRWSNDKDKGFGFSWWFWFWFFTSWGFGFGFGFGFGFGFFLFLGFGFGFGFGFGFGFGFGFGFGFGFGFGFGFGFGFFLGFGFGFGFGFGFGFGFBLGFGFGFGFGFGFFLTRCWCWGF
TRCWCWGFGFGFGFGFGFGFGFGFGFGFGFGFTRGFGFGFGFGFSWWDSWSWSWGFGFGFGFGFGFGFFLGFGFGFGFGFFLGFGFGFFLGFGFGFCPGFGFGFGFGFGFDKDKSNRWRWRWRWSNDKDKGFCRSWWDWNSWSWSWBLGFTRGFGFGFGFGFGFGFGFGFGFGFGFGFGFGFGFGFGFGFGFGFGFGFGFGFTRGFGFGFFLGFGFGFGFGFGFGFGFGFGFGFCWCWGF
GFCWCWGFGFGFGFGFGFGFGFGFTRGFGFGFGFGFGFLTCPCPCPCPCPCPCPCPCPCPCPCPCPCPCPCPCPCPCPCPCPCPCPCPCPCPCPCPCPCPCPCPCPCPCPDKDKSNBTBTRWRWSNDKDKCPCPCPCPCPCPCPCPCPCPCPCPCPCPCPCPCPCPCPCPCPCPCPCPLTGFGFGFGFGFGFGFGFGFGFGFGFGFGFGFGFGFGFGFGFGFGFGFGFGFGFGFCWCWGF
GFCWCWCWGFTRFLGFTRGFGFTRGFGFGFTRGFGFGFTRGFGFGFTRGFGFTRGFTRGFGFGFTRGFTRGFGFTRGFGFTRGFTRGFGFTRFLGFGFTRGFGFGFTRGFGFMKLTSNRWRWRWRWSNLTBNTRGFGFGFTRGFGFTRGFGFGFTRGFGFTRGFTRTRGFGFGFTRGFGFTRFLTRGFTRGFGFTRFLTRGFTRGFGFTRGFTRGFGFTRGFTRGFGFTRGFCWCWCWGF
GFCWCWCWCWCWCWCWCWCWCWCWCWCWCWCWCWCWCWCWCWCWCWCWCWCWCWCWCWCWCWCWCWCWCWCWCWCWCWCWCWCWCWCWCWCWCWCWCWCWCWCWCWCWCWCWCWCWSNRWRWRWRWSNCWCWCWCWCWCWCWCWCWCWCWCWCWCWCWCWCWCWCWCWCWCWCWCWCWCWCWCWCWCWCWCWCWCWCWCWCWCWCWCWCWCWCWCWCWCWCWCWCWCWCWCWCWCWCWFL
GFCWCWCWCWCWCWCWCWCWCWCWCWCWCWCWCWCWCWCWCWCWCWCWCWCWCWCWCWCWCWCWCWCWCWCWCWCWCWCWCWCWCWCWCWCWCWCWCWCWCWCWCWCWCWCWCWCWSNRWRWRWRWSNCWCWCWCWCWCWCWCWCWCWCWCWCWCWCWCWCWCWCWCWCWCWCWCWCWCWCWCWCWCWCWCWCWCWCWCWCWCWCWCWCWCWCWCWCWCWCWCWCWCWCWCWCWCWCWGF
GFGFDKDKDKDKDKDKBLDKDKDKDKDKDKDKDKDKDKDKDKDKDKDKDKDKDKDKDKCRDKDKDKDKDKDKDKDKDKDKDKDKDKDKDKDKDKDKCRDKDKDKDKCRDKDKDKDKCPCPCPCPDKDKDKDKDKDKDKDKDKDKDKDKDKDKDKDKBLDKBLDKDKDKCRDKDKDKDKDKCRDKDKDKDKDKBLDKDKDKDKDKDKDKDKDKDKDKDKDKDKBLDKCRDKDKDKDKGFGF
GFGFDKDKDKDKDKDKBLDKDKDKDKCRDKDKDKDKDKDKDKDKDKDKDKDKDKDKDKDKDKDKDKDKDKDKBLDKDKDKDKDKDKDKDKDKDKDKDKDKDKDKDKDKDKDKDKDKCPCPCPCPDKDKDKBLDKDKDKCRDKDKDKDKDKDKDKDKDKBLDKDKDKDKDKDKDKDKDKDKDKDKBLDKDKDKDKDKDKDKDKDKDKDKDKDKDKDKDKCRDKDKDKDKDKDKDKDKTRGF
SNSNSNSNPLDKPLRWRWRWRWRWRWRWSNSNPLDKPLSNSNSNSNSNSNSNSNSNSNSNGFGFDKGFGFGFGFGFGFSNSNSNSNSNPLDKPLSNSNSNSNSNSNSNSNRWRWRWCPCPCPCPRWRWRWSNSNSNPLDKPLSNSNSNSNSNSNSNSNSNGFDKGFGFGFGFGFGFGFGFSNSNSNSNSNPLDKPLSNSNSNSNSNSNSNRWRWRWPLDKPLRWRWRWRWSNSNSNSNSN
RWRWRWRWPLDKPLRWRWRWRWRWRWRWRWRWPLDKPLRWRWRWRWRWRWRWRWRWRWRWSNPLDKPLSNSNSNSNSNRWRWRWRWRWPLDKPLRWRWRWRWRWRWRWRWRWRWRWRWRWRWRWRWRWRWRWRWRWPLDKPLRWRWRWRWRWRWRWRWRWPLDKPLSNSNSNSNSNSNSNRWRWRWRWRWPLDKPLRWRWRWRWRWRWRWRWRWRWPLDKPLRWRWRWRWRWRWRWRWRW
RWRWRWRWPLDKPLRWRWRWRWRWRWRWRWRWPLDKPLRWRWRWRWRWRWRWRWRWRWRWRWPLDKPLRWRWRWRWRWRWRWRWRWRWPLDKPLRWRWRWRWRWRWRWRWRWRWRWRWRWRWRWRWRWRWRWRWRWPLDKPLRWRWRWRWRWRWRWRWRWPLDKPLRWRWRWRWRWRWRWRWRWRWRWRWPLDKPLRWRWRWRWRWRWRWRWRWRWPLDKPLRWRWRWRWRWRWRWRWRW
RWRWRWRWRWRWRWRWRWRWRWRWRWRWRWRWRWRWRWRWRWRWRWRWRWRWRWRWRWRWRWRWRWRWRWRWRWRWRWRWRWRWRWRWRWRWRWRWRWRWRWRWRWRWRWRWRWRWRWRWRWRWRWRWRWRWRWRWRWRWRWRWRWRWRWRWRWRWRWRWRWRWRWRWRWRWRWRWRWRWRWRWRWRWRWRWRWRWRWRWRWRWRWRWRWRWRWRWRWRWRWRWRWRWRWRWRWRWRWRW
RWRWRWRWRWRWRWRWRWRWRWRWRWRWRWRWRWRWRWRWRWRWRWRWRWRWRWRWRWRWRWRWRWRWRWRWRWRWRWRWRWRWRWRWRWRWRWRWRWRWRWRWRWRWRWRWRWRWRWRWRWRWRWRWRWRWRWRWRWRWRWRWRWRWRWRWRWRWRWRWRWRWRWRWRWRWRWRWRWRWRWRWRWRWRWRWRWRWRWRWRWRWRWRWRWRWRWRWRWRWRWRWRWRWRWRWRWRWRWRW
